00111111111000000011111111110000000000000000000000
00100000001001110010000000010000000000000000000000
00100000001010001010000000011100000000000000000000
00100000111111111111100000010100000000000000000000
00100000100000000000100000011100000000000000000000
00100000100000100000100000010000000000000000000000
00100000100001100000100000010000000000000000000000
00100000100001000000100000010000000000000000000000
00100000100001100000100000010000000000000000000000
00100000100000110000100000010000000000000000000000
00100000100000010000100000010000000000000000000000
00100000100000000000100000010000000000000000000000
00100000100000000000100000010000000000000000000000
00111111100000100000111111110000000000000001111110
00000000100000100000100000000000000000000001000010
00000000100000100000100000000000000000101001000010
00000000100000100000100000000011111001110001000010
00000000100000100000100000000010001010000001000010
00000000100000100000100000000010001001110001000010
00000000100000100100100000001010001001010001000010
00000000100000101110100000001010001001010001000010
00000000100000100100100000001010001001010001000010
00000000100000100000100110001010001001011001000010
00000000100000100000100100001011111001001001000010
00000000100000100000100111111000000001111001111110
00000000111111111111100000000000000001001000000000
00000000000000000000000000000000000001001000000000
00000000000000000000000000000000000000000000000000
00000000000000000000000000000000000000000000000000
00000000000000000000000000000000000000000000000000
